13232313323323221111313131221333121131222232121221212211211331331112123113232132
11132123232111212233323331311113113222121223211331123321133133221111123133223112
11111112213321211321313112122213111223233323231313222331121311232133123321313132
31332312122211131323313221223221332211221113123333131321221313222113111221321132
21111131112211222322331332112113111131211331133122311223123211331231321212122322
22322231112312123331223313233221131112122331313323133222323211322112112323213332
23133321212332222112321232232211333112121213123231222113311122311331233333333232
23332133332132113231313113313111212211133332122333312322222331133331322322322222
22133131211311321222131211313133331221213112233322211132332331321223231313123122
11213331132312112312111112321121122123121232323222232221312122223132111123113312
12212313323212323121333313311331113322323213212131221232233223111311233131233232
11312332211313111131333211112333133331331131212123133121131132111321312331331222
22211213122113233321122113122321133313122332233113322123131223132311332122322312
32133323112212233333321112332121311213232113222112211323211232313223231212132232
12221112231213323322111332111133111121133311311321311123133333131132232313132332
33133123322311122132223131132133123331131233322333232121222213211112231211211232
32123123122221331321113211322123321232233212222221131211122131313331233132332112
21113212113312212331331323211313233112232313212231122213313211123212113332322212
31311112112132331212311112331211131311233213321212113221333222232131331212211212
21321222113231131123212323313322131211232113233131212123123231221323233211313222
21312233111113122231231123122221122233313221112331222223132332112112132323323122
21312233312211213231131313111221213222231132332333232213331323121122231333233212
33121132221123333112121213223322132212112312112132333121311112333332231212221312
21312312113322121133322113221213233123113312213211313212122322212312312112232312
31132222222123312322211221221133322222113212231121112223211333331132233112313322
12321333123321331332233313232113313131123221122112222233313212213223331311111312
32232132231313212223322121123322111233211323332211111312122133123212321223123232
33213331111231131213211223312111221322212112123112313223213332212213311222233332
23331131313213131311213322112123321223223323222111322223111222222121332213231332
13232131333122311332132111112223232111231123132213332213111133123221311132233232
21131321123232113212112322111233213323121113331123323121113122331232131333221332
23112333122133322322121313321231333322131223312113221321321122221332122112112222
11213121113213221121333323123332132223313133132232331211222331211211111331211232
12313213222221131112113132121113133333232131232133323312333221233213312121331122
22232111211331233213313311223132313223233133212332331233133221331333212132233132
12333213313331232223221111212112223233233133121122113313333332231223311323132312
31212133331333131322223311321122232123123332323312323311223312321223123323331122
11313121221332321332111332111222132122222133321331121323132221333331322112111122
11213113122211132112213222322232322112332231221131321313122232311133231133232212
32232211122313121122232322232223132232231113112113131222111313232121323133123232
21313231113121331213121131123323131122323232332323323322333132333121223121332212
12223112231313223313333323312331312122211213221113232312311311221321221123213112
23221212111123222223222321222132222212332213131233312311232222123331232122313212
33313223233321112121231232321333321111112333123131322333223132312332111231331312
31231122123223123122322211131311132222232113333333133321133122121121113321212322
11111213112133211332312112311232332311312322332221233223123212111313332211132132
22232122211211211232313321123322133323312112113211222112132112331332313221232332
11123121132123133322231123311112332213111232312313312211332211131132331322111122
23321233222311313211221232123121123223212313211112321123122123321121321133132322
33212111213212313132333313321233121231321313121232322123113232331212223321121232
11133231323121213323121321321232231221223332221111111133231311131332322213131112
12113222111232332331332232313212323221332112211132223123222313211221231221322232
21333331331122133222132232323213331111213231131212122323223213312213233232131122
32221322111323231232111222321132332222323221311131223333231323333132122233211212
32131131221232222231122112313113132112232322112111222113323322231333323211113222
32211313333233232111212232231212132223232232321331121233323123333231123221132222
12213312311111112123121222333122111231223211221132113123323311322112223112213122
12131331121313123132331113211123313131222112121332312132112312222331333113332132
12313121333111312312312212311322332233112331222333223221121311233213231231211232
21131132121332221111123312123111213333133321121213222123321333311323321112113122
32332312312131223112212112213233112332233132322312312322113212211211212123122112
33331321211312131123112231313231111312221322312221112331213211211133311132123322
32213312231132223223111323222132321233112122112323321331213232123322111223131112
21233132333332232312313322111231213233132331333121121112333313232322223223232122
12123332232123123233232111322132133122111221233313123213112331313123321232221132
12321332121113331131122321132313133131112121332211111212121312311231133331131222
22133121232222211131232222221131211111221212323322212332213112112221322123222332
32131332323231222313221112122333211233333312322213312332121121311332222231312222
23131111113313333121311333112221131232222112211221111332233123223313211323113312
31332312323223233211322113321312331211321112223312121211212233131331312123332212
21332332112111322231222111122232131131113132213123231331313312333322332113333322
32223332212333312211111323321211113333123123111131232212322233132221123231322222
13211111112311211233231222222213221331212121112122213111331212231322312312332132
33113213112223221321113231122121213232312121212131222323231223213133133332212132
21213111232211213123312222121333332212223223321132111121232211222321212333331312
13333131131232323213311312313113212332121223131211232233123211312231112132332112
31321233323312132322221223312313223132212233122332133213222331232333331213332132
22323211312112113331233331122231321213312133313123112211331211312332121312132312
31112233121113213233312111322222312332122231223333223313331333333333212132222322
11111111111111111111111111111111111111111111111111111111111111111111111111111110